NO ./path_to_the_north_texture

SO ./path_to_the_south_texture


WE ./path_to_the_west_texture


EA ./path_to_the_east_texture




F 222,222,222


C 225,30,0


        1111111111111111111111111
        1000000000110000000000001
        1011000001110000000000001
        1001000000000000000000001
11111111011000001110000000000001
100000000011000001110111111111111
111101E11111111011100000010001
11110111111111011101001010001
11000000110101011100000010001
10000000000000001100000010001
10000000000000001101010010001
110000011101010111110111100111
1110111 1110101 101111010001
11111111 1111111 1111111111111